#!/bin/bash





'echo -c "

      * ***               ***                                                                                  
    *  ****  *             ***      *                                                                          
   *  *  ****               **     ***                                                                         
  *  **   **                **      *                                                                          
 *  ***           ****      **               ****              **   ****                                       
**   **          * ***  *   **    ***       * **** *    ***     **    ***  * *** **** ****                     
**   **         *   ****    **     ***     **  ****    * ***    **     ****   *** **** ***  *                  
**   **        **    **     **      **    ****        *   ***   **      **     **  **** ****                   
**   **        **    **     **      **      ***      **    ***  **      **     **   **   **                    
**   **        **    **     **      **        ***    ********   **      **     **   **   **                    
 **  **        **    **     **      **          ***  *******    **      **     **   **   **                    
  ** *      *  **    **     **      **     ****  **  **         **      **     **   **   **                    
   ***     *    ******      **      **    * **** *   ****    *   ******* **    **   **   **                    
    *******      ****       *** *   *** *    ****     *******     *****   **   ***  ***  ***                   
      ***                    ***     ***               *****                    ***  ***  ***                  
                                                                                                               
                                                                                                               
                                                                                                               
                                                                                                               
                                                                                                               
                                                                                                               
        **             **                                                                                      
     *****              **                                           *                                         
    *  ***              **   **                                     **                                         
       ***              **   **                                     **                                         
      *  **             **    **    ***                           ******** **   ****     ***  ****             
      *  **         *** **     **    ***     ***    ***  ****    ********   **    ***  *  **** **** *    ***   
     *    **       *********   **     ***   * ***    **** **** *    **      **     ****    **   ****    * ***  
     *    **      **   ****    **      **  *   ***    **   ****     **      **      **     **          *   *** 
    *      **     **    **     **      ** **    ***   **    **      **      **      **     **         **    ***
    *********     **    **     **      ** ********    **    **      **      **      **     **         ******** 
   *        **    **    **     **      ** *******     **    **      **      **      **     **         *******  
   *        **    **    **     **      *  **          **    **      **      **      **     **         **       
  *****      **   **    **      *******   ****    *   **    **      **       ******* **    ***        ****    *
 *   ****    ** *  *****         *****     *******    ***   ***      **       *****   **    ***        ******* 
*     **      **    ***                     *****      ***   ***                                        *****  
*                                                                                                              
 **"
'
